S...#.....
.###.###..
...#...#..
.#.#####..
.#........
.#######..
.......#..
.#####.#..
.#...#.#..
...#...#.E
