S#.#....##...#..#..#..#.###...#..#..#...#.##...##.##.......#...#.#
..#.##.#....##.#.##..#...#...#........#.##....##.#...#..##.......#
.........#.##..#..#....#...##.####......##..........#.#...##.....#
...#.#..####...#..#...##.#...#....##.##...#.##....#..#..##........
...####...###..###..###.....###....#.#.#......#.#.##....#..#..#.#.
...#.....#..#....#...##.......###....#.#.#....#.....##....#....#..
.......#...#....................####..###.#.##..#..#..##.#...#.##.
..#.......#...#....#..#.......#..#...#....####..#....##........##.
.###..##...##.###..#..#..#.#..#....##....#..#......#.......#......
...#...##.......#.....###.#..#..#.#.##.....##..#..#.#...#.#.##.#..
...#.#...##.#.#.#....#...#...#..#......##...#...####........##..#.
.#....##..#.....#.#....#.#....#....##.#....##.#..#.#..#.....####..
...#...#.....#...#.#...#...#....##.#.......###..#..........#......
...##.##.##...#........#...##..#.....#.....##.#...##.#...#...#.##.
........####........#..#.#.#.........#.#....................#.....
#####...#....#....#.......#...#..#......#.##......###.###...#...##
.##.....#.###.#.....#.......#.........##........##....##...#.#....
#.##..##.#..#.##.#.#.#.....###...#...#...##.###....#......##...#..
####.##.#.##....#.#.#.#.#.#.##.....#..#.#..#.#..##.###.#..###..#..
......#.#..............##..#..####.....##......#.#...##....#.##.##
#....###..#...#...#.#...###......#..#....#....#......##..#....##..
##....#...#..###..##...#....#....#.....#....##.#..#..#......#.....
#.#...#..#.#..##.#.#..##.......#..###.....#...#.#.#....##.#..##...
..#..#.#.#.#.#..#....###.#.....#..##...#...##....#........##.#.##.
.#.#.........#..###....#...#....##...###......########.....#...##.
.####..#..#....#.##.#..##..#.#..#...#.....#.....###.....#.....##..
...#....#.....##..#.##....#...#...#...##....#...#.##..#.##...#..##
#.....#..#..##....#......#....##...#..#.....#.##.##..#......##..#.
...#....##....##.......#..#........#.....#.#......#....##.#.#..#..
..#...###..##.#.....###....##.....##.####.......##....#.#..#....##
.#.#........#....#..#.#....#....#.....#....#..#.#..#.#........####
...##.....#..#..#.##.##.#..##.#....#....#..#..#......#...##......#
....#.##.....#...#....#..##.#.#.#........#..#.........#.....#.....
....##........#...#.#..####.........#.#.##...#......##.....#.##..#
.........##........#........##.#.##..#..##...........##...##.#....
.......#..#......#.##...#....#.#.#..##.....#.#.##.##..#.##.....#..
.......#..###...#..#....##......#......#.........##..#...###.#.#..
.......##..............#.##.###...#.###.#.##..#..#...#.#..#.#.....
#.#.##..#.....#.###..##.###..#.#....#...........#..##..#.#..#..#..
##..#.##.#.#...#..#.###........#.#.............##.......#........#
.....#.#..##.#.##.#.........###...##.#.....#......#.....#.##...#..
...............#.#...##..#......#....##.........###....#..#..#..##
.#.......#....##...#.#.##..#..##..........#...#####.#...#...#.....
....##.##.###.##.#.#..##.#.#..#........#.#..##.#..#..#...#.##....#
.##...#..#....#...#.#.#..#..#.....#.#..#.##..#.#.#..#..#.....#...#
###..#....#..##....#.####...#.....##..#..#.#.....####..#..#..##.#.
....#....#.#..#...#......##..........#...#..#....#.......#....#..#
...#..##.##....##.##.............##...#..#.......#.##...##.#.#....
..##........###.##....#.....#.....##.....#.....##.#.....##..#.....
.....####..#........##..#.....#.#.#..##.#.....##.##...##.....#..##
.#.....#..#.....##...#.#.#..#...#..#.###....##.###.#....#.#....#..
.##....##...#.#....#.....##.....#....#.#...##......#.......#......
.#.##.....#....#........##....#.....#..#..#.......#..##...........
....#.........#......#....#.....#.#....#....#..#..#..#...###....#.
..#.#........##.#....#...#....##....###.#.#.#...#.....##.#...#.##.
#.###..#.#...#.....##..#..##.#..#.#...#...#.#..##...##.#.....#.#..
.#.#...##..........##........#...#.#.#.....................#..##..
..#....##.###.#....#........#.##.##..#.....#..#...###..#.......##.
..#........#...........#....#..#..#...#.#......##.#...#...###...#.
.#.#...##..##.##.#####..##...###.....##..#..#.#.##..#.#......##..#
.........#..##..#.#.#.#.....#.#...#..#.##.#....#....###.....#####.
##..#.............#.#.#......#..#....#....#.##...........#.....###
....#.#..#.#.......##..#.#...##............#.#.........##...#....#
.#.#......#.....#..#...#....####.....#..#.#..#....##...#.#........
...#..#.#....##.....#.###......##.##......#.......##.....#..#.....
....##....#.....#.##..........###.....#...####.#...#.#..#.....#.#E
