S...............................####.....#..#.#..#.#.....#..#.###.
.............................#..#....#..#......###...#.....##.##..
...............................#...##......#######.#.......#.#...#
.......######..........##.........###...########.###############..
............#####...#####.#...#####.#######.#.....##.....#........
#############.....##....#.##.#########..#..###....................
#..............#.##....#####..####.....##.##..##.#..#..#..........
..............#.....##.###.###....#..#..#.#......##..#............
...........###....###.##..###.....#.#...###.#.####.####...#.......
..........#.....###...#..###.#....#.......#..###.###.#......#.#.##
.......##....##..#...##..##......###.###########.##.........#.####
.....###...####.....##....#######.#...###.####.#...#...#......#...
....##..............#...###.##.#..#...#.....###...#.#.....####....
.##.###..........#.#......###.#...#........##.#..#....#.###.#.#.##
#.#..###..........##....##.##....##.##.#.####...#.#.###.##........
......#.....#..#..##.....##.####.#.#.....#.#.#.###.#..#...........
......#.....#....#......##.#...###..#.....####....#..............#
......#.#........#.....##.#.....###...######.......#............##
......##...#..#.#.....###....#...###........#..#...............#..
#..#...##......#.....##....#..####.#..#..#...#..######.##....#....
....#.##......##.....##...##....##.#....#...####.###..#.#...#.....
.##...##......#.##..###......##.#..#.....#...###..#.###..#.#......
##.#....#.....#...##...###.##..#...#..###.#.#.##.##.#...##........
#.......##....#...#......#####.#...#..#..####.#..#.######.........
#........#.#..##.#.#...####.#.###..#.#..#..#.......#..####...#....
..........#....##.........#......#####.#......#...#...#...#.....#.
...........#....#####.#..#..##.....########.......#.###...##......
.......##...#.......####.##.#.#####........###########.....#.#....
.......##....###.....##.#######..#.......#.#####.#...###...#......
.......##.....##........##.#..##############...##...#..#..##......
....##...#...#..#......#.#####..##..#....#....###..#...#...#......
....##.#.#...#...##.....#.#....##............###..##..##....#..###
..........#........###..##....#.#..........###.#..#....#..#.##.##.
..........###........#####...###......#..###.##..##.#.##....###...
...........#............##.##..........###..##...#....#..##.##...#
......#....##..........#..###.#.....###...###.#.#.....#....###....
............#.........#.###.###...####...#####..#..#.###...#....##
............###......#####.#...####....###.#..####..##....#.##....
........#....#...#..#...##....###..#######....#..#..##......#.....
.#.#......#...#.#..##..#..#.###.......###############.#....##.....
.......##...#.##.###.#.#.........##.###.#..#.#...#.....#..##..#...
........####...#.#..#.#........#...###.###..#............##.......
..#...#..#.###.#######............#.####.#.#............##........
....#........###..#........#....##..#.###..#.#.........##.........
.....#...........#.#...........##....######....#......##..........
....#...........#.#.....#.....##.......#.##....#......##...##.....
....#....#.....#.#....#.......#....#...##..###.......##...#####...
..............###..............##.....###.############.......##...
...#........#.##..#.#.#...#............#####.##.....##.......#....
...#........#.###..............#...#####.##...#....##.#.##...##...
..#.........##..................###..#...##...###.##.#......###...
..#...#.....##................##....#...##.#...#.##..#.....##.####
........................#...##.....##..#....############.##.####..
.#........#.###...........##......#...##........#.......###.#.#...
.#.#....##..##.........##........##..#.........#......#########...
........#...##.......##..........#..##........#....###......###...
#.....##.......##..##.#.....#...#..#....#...##.....###......######
...#..#..........#####..#....#.#..#........#.........##.....#.###.
#....#.........##..##.........#..#........##...........####.#.##..
...##..#.....##..............####........###.....#.........#####..
...#..#....##...#.......#.....#.........#........########...#...#.
..#......##...##..........###...#......#........##..........#.....
##......#........#...#####.......#....##........#...........#.....
#..........##########....#...........##.........#....#......#.....
.....######.....................................#...#.......#.....
..####...............#..........................#................E
